NO ./textures/north_texture.xpm
SO ./textures/south_texture.xpm
EA ./textures/east_texture.xpm
WE ./textures/west_texture.xpm
F 42,55,57
C 255,255,255

   1111111     
   1000001     
  1100000111        11111111111111111111
  100000000111    1110000000000000000001
  10000000000111111000000011111111111111
  1111111110000000000000001
          11111000001111111
              1000001
              1111111