NO ./textures/texture.xpm
SO ./textures/texture2.xpm
WE ./textures/texture3.xpm
EA ./textures/texture4.xpm

F 300,128,128

C 127,255,212

111111111111111
100000000000001
100000000000001
100000000000001
1000000N00000011111
100000000000000000111111111
100000000000000000100000001
100000000000000000100000001
111111111111000000100000001
100000000000000000100000001
100000000000000000000000001
100000000000000000000000001
100000000000000000000000001
111111111111111111111111111