NO ./textures/texture.xpm
SO ./textures/texture2.xpm
WE ./textures/texture3.xpm
EA ./textures/texture4.xpm



C 225,30,0
F 220,100,0

1111 1111111111111
100000000000000001
100000000111100001
1000 0000001100001
10000000N001100001
100000000001100001
100000000000100001
111111111111111111