NO ./textures/texture.xpm
SO ./textures/texture2.xpm
WE ./textures/texture3.xpm
EA ./textures/texture4.xpm

F 128,128,128

C 127,255,212

111111111111111
100000000000001
100000000000001
100000000000001
100000N00000011111111
100000000000000000111111111
100000000000000000100000001
100000000000000000100000001
111111111100000000100000001
100000000000000000100000001
100000000000000000000000001
100000000000000000000000001
100000000000000000000000001
111111111111111111111111111
